                                                                                
                                                                                
    +------------------------------------------------------------------------+
    |........................................................................|
    |........................................................................|
    |........................................................................|
    |........................................................................|
    |........................................................................|
    |........................................................................|
    |........................................................................|
    |........................................................................|
    |........................................................................|
    |........................................................................|
    |........................................................................|
    |........................................................................|
    |........................................................................|
    |........................................................................|
    |........................................................................|
    |........................................................................|
    |........................................................................|
    |........................................................................|
    |........................................................................|
    |........................................................................|
    |........................................................................|
    |........................................................................|
    |........................................................................|
    |........................................................................|
    |........................................................................|
    |........................................................................|
    |........................................................................|
    |........................................................................|
    |........................................................................|
    |........................................................................|
    |........................................................................|
    |........................................................................|
    |........................................................................|
    |........................................................................|
    |........................................................................|
    |........................................................................|
    |........................................................................|
    |........................................................................|
    |........................................................................|
    |........................................................................|
    |........................................................................|
    |........................................................................|
    |........................................................................|
    |........................................................................|
    |........................................................................|
    |........................................................................|
    |........................................................................|
    |........................................................................|
    |........................................................................|
    |........................................................................|
    |........................................................................|
    |........................................................................|
    |........................................................................|
    |........................................................................|
    |........................................................................|
    |........................................................................|
    |........................................................................|
    |........................................................................|
    |........................................................................|
    |........................................................................|
    |........................................................................|
    |........................................................................|
    |........................................................................|
    |........................................................................|
    |........................................................................|
    |........................................................................|
    |........................................................................|
    |........................................................................|
    |........................................................................|
    |........................................................................|
    |........................................................................|
    |........................................................................|
    |........................................................................|
    +------------------------------------d-----------------------------------+

                                                                                
                                                                                
     
