                                                                                
                                                                                
    +------------------------------------------------------------------------+
    |........................................................................|
    |........................................................................|
    |........................................................................|
    |........................................................................|
    |........................................................................|
    |........................................................................|
    |........................................................................|
    |........................................................................|
    |........................................................................|
    |........................................................................|
    |........................................................................|
    |........................................................................|
    |........................................................................|
    |........................................................................|
    |........................................................................|
    |........................................................................|
    |........................................................................|
    |........................................................................|
    |........................................................................|
    |........................................................................|
    |........................................................................|
    |........................................................................|
    |........................................................................|
    |........................................................................|
    |........................................................................|
    |........................................................................|
    |........................................................................|
    |........................................................................|
    |........................................................................|
    |........................................................................|
    |........................................................................|
    |........................................................................|
    |........................................................................|
    |........................................................................|
    |........................................................................|
    |........................................................................|
    |........................................................................|
    |........................................................................|
    |........................................................................|
    |........................................................................|
    |........................................................................|
    |........................................................................|
    |........................................................................|
    |........................................................................|
    |........................................................................|
    |........................................................................|
    |........................................................................|
    |........................................................................|
    |........................................................................|
    |........................................................................|
    |........................................................................|
    |........................................................................|
    |........................................................................|
    |........................................................................|
    |........................................................................|
    |........................................................................|
    |........................................................................|
    |........................................................................|
    |........................................................................|
    |........................................................................|
    |........................................................................|
    |........................................................................|
    |........................................................................|
    |........................................................................|
    |........................................................................|
    |........................................................................|
    |........................................................................|
    |........................................................................|
    |........................................................................|
    |........................................................................|
    |........................................................................|
    |........................................................................|
    |........................................................................|
    +-----------------------------------cd-------o---------------------------+

                                  p                                              
                                                                                
     
